{
  "Dungeons": [
    {
      "Dungeon": "a",
      "Screens": [
        {
          "Layout": [
            "#####......#####",
            "#|............>#",
            "#..............#",
            "......*...*.....",
            "................",
            "................",
            "......*...*.....",
            "#.............|#",
            "#<..........|||#",
            "######aaaa######"
          ],
          "Position": {
            "X": 0,
            "Y": 0
          }
        },
        {
          "Layout": [
            "################",
            "#||...........>#",
            "#..............#",
            ".....*####.....#",
            "......a###.....#",
            "......a###.....#",
            ".....*####.....#",
            "#..............#",
            "#<.............#",
            "################"
          ],
          "Position": {
            "X": 1,
            "Y": 0
          }
        },
        {
          "Layout": [
            "################",
            "#*............>#",
            "#..............#",
            "#....######.....",
            "#....#$$$$#.....",
            "#....#$$$$#.....",
            "#....######.....",
            "#..............#",
            "#<...........||#",
            "################"
          ],
          "Position": {
            "X": -1,
            "Y": 0
          }
        },
        {
          "Layout": [
            "################",
            "#*............*#",
            "#..............#",
            "#..............#",
            "#..............#",
            "#..............#",
            "#..............#",
            "#..............#",
            "#..............#",
            "#####......#####"
          ],
          "Position": {
            "X": 0,
            "Y": -1
          }
        }
      ]
    },
    {
      "Dungeon": "b",
      "Screens": [
        {
          "Layout": [
            "################",
            "######........>#",
            "####|..........#",
            "###|....(((....#",
            "##|.............",
            "#...............",
            "#..............#",
            "#<.............#",
            "######....######",
            "#######bb#######"
          ],
          "Position": {
            "X": 0,
            "Y": 0
          }
        },
        {
          "Layout": [
            "################",
            "#.............>#",
            "#..............#",
            "#..............#",
            "...............#",
            "...............#",
            "#..............#",
            "#..............#",
            "#<.............#",
            "################"
          ],
          "Position": {
            "X": 1,
            "Y": 0
          }
        }
      ]
    }
  ]
}
