{
  "Screens": [
    {
      "Layout": [
        "################",
        "########!!!!!!!#",
        "####a##%..!!!!!#",
        "###*.*.......!!#",
        "##............!#",
        "#..............#",
        "...............#",
        "...............#",
        "#..............#",
        "################"
      ],
      "Position": {
        "X": 0,
        "Y": 0
      },
      "Enemies": [

      ]
    },
    {
      "Layout": [
        "#######..#######",
        "#..............#",
        "#....######....#",
        "#....#$$$$#....#",
        "#....#$@@$#....#",
        "#....#$@@$#....#",
        "#....#$$$$#.....",
        "#....######.....",
        "#..............#",
        "################"
      ],
      "Position": {
        "X": -1,
        "Y": 0
      },
      "Enemies": []
    },
    {
      "Layout": [
        "################",
        "#....#.........#",
        "#....#..#####..#",
        "###..#......#..#",
        "..#.........#..#",
        "..#...#######..#",
        "#.....#........#",
        "####..#..#######",
        "#.....#........#",
        "#######..#######"
      ],
      "Position": {
        "X": -1,
        "Y": -1
      },
      "Enemies": []
    },
    {
      "Layout": [
        "################",
        "######.........#",
        "####....@@@@...#",
        "##......@$$@...#",
        "#.......@$$@....",
        "#.......@@@@....",
        "#..............#",
        "#..(((.........#",
        "#..............#",
        "###########..###"
      ],
      "Position": {
        "X": -2,
        "Y": -1
      },
      "Enemies": []
    },
    {
      "Layout": [
        "###########..###",
        "#..............#",
        "#....##........#",
        "#...####.##....#",
        "#..#####b##....#",
        "############...#",
        "############...#",
        "#.(..((((......#",
        "#..............#",
        "#####..#########"
      ],
      "Position": {
        "X": -2,
        "Y": 0
      },
      "Enemies": []
    },
    {
      "Layout": [
        "#####..#########",
        "#..............#",
        "#...!!....!!...#",
        "#...!!....!!...#",
        "#......$$......#",
        "#......$$......#",
        "#...!!....!!...#",
        "#...!!....!!...#",
        "#..............#",
        "#######..#######"
      ],
      "Position": {
        "X": -2,
        "Y": 1
      },
      "Enemies": []
    },
    {
      "Layout": [
        "#######..#######",
        "#.....#..#.....#",
        "#.!.!.#..#.-.-.#",
        "#.....#..#.-.-.#",
        "#.!.!.#..#.....#",
        "#.....#..#######",
        "#.!.!.#.........",
        "#.....#.........",
        "################",
        "#@@@@@@@@@@@@@@#"
      ],
      "Position": {
        "X": -2,
        "Y": 2
      },
      "Enemies": []
    },
    {
      "Layout": [
        "...#..#..#######",
        ".!.#..#..#.....#",
        "...#..#..#......",
        ".!.#..#..#.....#",
        "...#..#..#######",
        "####..#.....#...",
        "......#.....#.!.",
        "......#%....#...",
        "##########..#.!.",
        "@@@@@@@@@#..#..."
      ],
      "Position": {
        "X": -1,
        "Y": 2
      },
      "Enemies": []
    },
    {
      "Layout": [
        "################",
        "#...............",
        "#.##############",
        "#.##............",
        "#.##............",
        "#.##..##########",
        "#.##..#.........",
        "#.##..#.........",
        "#.##..#..#######",
        "####..#..#@@@@@@"
      ],
      "Position": {
        "X": -1,
        "Y": 1
      },
      "Enemies": []
    },
    {
      "Layout": [
        "################",
        "...............#",
        "##.............#",
        "....#########..#",
        "....#!!!!!!!#..#",
        "#############..#",
        "...........##..#",
        "...........##..#",
        "#..######..##..#",
        "#..#@@@@#..##..#"
      ],
      "Position": {
        "X": 0,
        "Y": 1
      },
      "Enemies": []
    },
    {
      "Layout": [
        "#..######..##..#",
        "#..##......##..#",
        "...##......##..#",
        "#####..######..#",
        "#......#!!!!#..#",
        "#......#!!!!#..#",
        "#..##########..#",
        "#..............#",
        "#..............#",
        "################"
      ],
      "Position": {
        "X": 0,
        "Y": 2
      },
      "Enemies": []
    },
    {
      "Layout": [
        "##########..####",
        "#..............#",
        "#...)))........#",
        "#...)))........#",
        "#....%........##",
        "#.............##",
        "............####",
        "..........######",
        "#.......########",
        "################"
      ],
      "Position": {
        "X": -1,
        "Y": 3
      },
      "Enemies": []
    },
    {
      "Layout": [
        "################",
        "#..............#",
        "#..............#",
        "#..............#",
        "#..............#",
        "#..............#",
        "#...............",
        "#...............",
        "#..............#",
        "################"
      ],
      "Position": {
        "X": -2,
        "Y": 3
      },
      "Enemies": []
    }
  ]
}
