{
  "Screens": [
    {
      "Layout": [
        "#######..#######",
        "#######........#",
        "####a##.........",
        "##*...*.........",
        "##.............#",
        "#..............#",
        "................",
        "................",
        "...............#",
        "#...####...#####"
      ],
      "Position": {
        "X": 0,
        "Y": 0
      }
    },
    {
      "Layout": [
        "#######.########",
        "#..............#",
        "#.###..........#",
        "#.#.............",
        "#.#............#",
        "#............###",
        "#...........####",
        "3..........#####",
        "#.........######",
        "##..############"
      ],
      "Position": {
        "X": 1,
        "Y": 0
      }
    },
    {
      "Layout": [
        "################",
        "#..............#",
        "#.$$$$$$$$$$$$.#",
        "#.$$$!.bb.!$$$.#",
        "#.$$$......$$$.#",
        "#.$$$......$$$.#",
        "#.$$$!....!$$$.#",
        "#.$$$$$..$$$$$.#",
        "#..............#",
        "#######..#######"
      ],
      "Position": {
        "X": 0,
        "Y": -1
      }
    },
    {
      "Layout": [
        "#...####...#####",
        "#..............#",
        "#..!...........#",
        "#..!..####.....#",
        "#..!..#$$#..!..#",
        "#.....#$$#..!..#",
        "#.....####..!..#",
        "#...............",
        "#...............",
        "################"
      ],
      "Position": {
        "X": 0,
        "Y": 1
      }
    },
    {
      "Layout": [
        "################",
        "#$$$.!...*.&&&.#",
        "#$...!......&..#",
        "#$$$.!!!.*..&..#",
        "#..$.!.!.*..&..#",
        "#$$$.!.!.*..&..#",
        "#...............",
        "#...............",
        "#...............",
        "################"
      ],
      "Position": {
        "X": -1,
        "Y": 0
      }
    },
    {
      "Layout": [
        "##..############",
        "#...#.####.....#",
        "#.###.###......#",
        "#...........##.#",
        "#####.###...##..",
        "#####.#...####..",
        "#..##.#.#.####.#",
        "......#.#......#",
        "...##...########",
        "################"
      ],
      "Position": {
        "X": 1,
        "Y": 1
      }
    },
    {
      "Layout": [
        "#.##############",
        "#..............#",
        "####.#########.#",
        "####.#.......#.#",
        "...#.#.#####.#.#",
        "...#.#######.#.#",
        "##.#.........#.#",
        "##.###########.#",
        "##.............#",
        "################"
      ],
      "Position": {
        "X": 2,
        "Y": 1
      }
    },
    {
      "Layout": [
        "################",
        "#...............",
        "#.############..",
        "#.#..........#.#",
        "#.#.####.###.#.#",
        "#.#.########.#.#",
        "#.#..........#..",
        "#.#####.######..",
        "#..............#",
        "#######.########"
      ],
      "Position": {
        "X": 1,
        "Y": -1
      }
    },
    {
      "Layout": [
        "################",
        "#..............#",
        "#.######.#..##.#",
        ".......#.#..##.#",
        "#####..#.#.###.#",
        "##.....#.#.....#",
        "#........#.####.",
        "#.#.#.#..#......",
        "#.########...###",
        "#.##############"
      ],
      "Position": {
        "X": 2,
        "Y": 0
      }
    },
    {
      "Layout": [
        "###.############",
        "#..............#",
        "#.###.########.#",
        "#.###.########.#",
        "#.....##.....#.#",
        "###.####.!.!...#",
        "..#...##........",
        "..###.##.!.!...#",
        "#.....##.......#",
        "################"
      ],
      "Position": {
        "X": 3,
        "Y": 0
      }
    },
    {
      "Layout": [
        "################",
        "###............#",
        "##.............#",
        "#.............##",
        "#............###",
        "#..............#",
        ".............#.#",
        "#.....########.#",
        "#....##........#",
        "#######.########"
      ],
      "Position": {
        "X": 4,
        "Y": 0
      }
    },
    {
      "Layout": [
        "#######.########",
        "#..............#",
        "#...##...##....#",
        "#..#..#.#..#...#",
        "#..#...#...#...#",
        "#...#.....#....#",
        "#....#...#.....#",
        "#.....#.#......#",
        "#......#.......#",
        "######...#######"
      ],
      "Position": {
        "X": 4,
        "Y": 1
      }
    },
    {
      "Layout": [
        "################",
        "...#...........#",
        "...#.#########.#",
        "##.#.#.........#",
        "##...#.#########",
        "########........",
        ".......#.#####.#",
        "..######.#####.#",
        "#..............#",
        "################"
      ],
      "Position": {
        "X": 2,
        "Y": -1
      }
    },
    {
      "Layout": [
        "######....######",
        "#..............#",
        "#.####....###..#",
        "#.####....###..#",
        "#.###########..#",
        "..###.......#..#",
        "#.###.#####.#..#",
        "#.#...#####....#",
        "#.#.############",
        "###.############"
      ],
      "Position": {
        "X": 3,
        "Y": -1
      }
    },
    {
      "Layout": [
        "################",
        "##............##",
        "#....$$$$$$....#",
        "#....$$$$$$....#",
        "#....$$$$$$....#",
        "#....$$$$$$....#",
        "#....$$$$$$....#",
        "#..............#",
        "#..............#",
        "######....######"
      ],
      "Position": {
        "X": 3,
        "Y": -2
      }
    },
    {
      "Layout": [
        "#######....#####",
        "#..............#",
        "#..!...........#",
        "#..!..####.....#",
        "#..!..#$$#..!..#",
        "#.....#$$#..!..#",
        "#.....####..!..#",
        "#...............",
        "#...............",
        "################"
      ],
      "Position": {
        "X": 4,
        "Y": 2
      }
    }
  ]
}