{
  "Screens": [
    {
      "Layout": [
        "################",
        "#..............#",
        "#..............#",
        "#......#.......#",
        "#......#.......#",
        "#......#.......#",
        "#......#.......#",
        "#..............#",
        "#..............#",
        "################"
      ],
      "Position": {
        "X": 0,
        "Y": 0
      },
      "Enemies": [
        {
          "Type": "Vampire",
          "Position": {
            "X": 3,
            "Y": 3
          }
        }
      ]
    }
  ]
}